╔═════════ BASTIDOR ═════════╗
║    ██ ██           ██ ██   ║
║  │──────│        │──────│  ║
║  │──────│        │──────│  ╝
╚  🦊      ██      ██        ╗
╔   ████       ██   ██    ██ ║
║  ██    ██      🐰     ████ ║
╚════════════════╝ ╚═════════╝