╔═════════ BASTIDOR ═════════╗
║    ██ ██           ██ ██   ║
║  │──────│        │──────│🐰║
║  │──────│    🐤  │──────│  ╝
╚          ██      ██        ╗
╔   ████       ██   ██    ██ ║
║  ██    ██             ████ ║
╚════════════════╝ ╚═════════╝