╔═════════ BASTIDOR ═════════╗
║    ██ ██   🐰      ██ ██   ║
║  │──────│        │──────│  ║
║  │──────│        │──────│  ╝
╚          ██      ██        ╗
╔   ████       ██   ██    ██ ║
║  ██    ██             ████ ║
╚════════════════╝ ╚═════════╝