╔═════════ BASTIDOR ═════════╗
║ 🐤 ██ ██           ██ ██   ║
║  │──────│        │──────│  ║
║  │──────│        │──────│  ╝
╚          ██      ██        ╗
╔   ████       ██   ██    ██ ║
║  ██ 🐰 ██           🦊████ ║
╚════════════════╝ ╚═════════╝