╔═════════ BASTIDOR ═════════╗
║    ██ ██           ██ ██   ║
║  │──────│        │──────│  ║
║  │──────│        │──────│  ╝
╚          ██      ██   🐤   ╗
╔   ████       ██   ██    ██ ║
║  ██    ██             ████ ║
╚════════════════╝ ╚═════════╝