╔═════════ BASTIDOR ═════════╗
║    ██ ██           ██ ██   ║
║  │──────│        │──────│  ║
║  │──────│     🦊 │──────│  ╝
╚          ██      ██        ╗
╔   ████       ██   ██    ██ ║
║  ██    ██          🐤 ████ ║
╚════════════════╝ ╚═════════╝