╔═════════ BASTIDOR ═════════╗
║    ██ ██           ██ ██   ║
║  │──────│        │──────│  ║
║  │──────│        │──────│  ╝
╚          ██      ██        ╗
╔   ████       ██   ██    ██ ║
║  ██    ██   🦊        ████ ║
╚════════════════╝ ╚═════════╝