╔═══════════════════════╗
║ 🎈🎈           🎈🎈 ║
║                       ║
║  │██│   │○██│   │○█│  ║
║  │○█│   │███│   │██│  ║
║       🐤              ║
║  │██│   │██○│   │██│  ║
╚  │█○│   │███│   │█○│  ╝
╔                       ╗
║ 🎈🎈           🎈🎈 ║
╚═══════════════════════╝