╔════════════════════════════════════╗
║     ║‾‾‾‾‾‾‾‾‾‾‾‾‾‾‾‾‾‾‾‾‾‾‾‾║     ║
║     ║        ESCENARIO       ║     ║
║ ╔═══╩════════════════════════╩═══╗ ║
║ ║     🔆        🔆         🔆    ║ ║
║ ║   ┌────┐    ┌─────┐    ┌────┐  ║ ║
║ ║   │ 🐰 │    │     │    │ 🐤 │  ║ ║
║ ║   │    │    │     │    │    │  ║ ║
║ ║   └────┘    └─────┘    └────┘  ║ ║
╔═                                  ═╗
║ ║  ║‾‾‾‾‾‾‾║           ║‾‾‾‾‾‾‾║ ║ ║
║ ╚════════════════════════════════╝ ║
╚════════════════════════════════════╝