╔══════════ PIRATE COVE ══════════╗
║       ┌──────────────────┐      ║
║       │ │█│█│█    █│█│█│ │      ║
║       │   └█└█    █┘█┘   │      ║
║       └┐ 🔆 └█    █┘ 🔆 ┌┘      ║
║        └─────🪧──────────┘       ║
║                 🐰              ║
╚═════════════════════════════════╝