╔══════════ PIRATE COVE ══════════╗
║       ┌──────────────────┐      ║
║       │ │█│█│█ 🦊 █│█│█│ │      ║
║       │   └█└█    █┘█┘   │      ║
║       └┐ 🔆 └█    █┘ 🔆 ┌┘      ║
║        └─────🚫──────────┘       ║
║                       🐰        ║
╚═════════════════════════════════╝