╔══════════ PIRATE COVE ══════════╗
║       ┌──────────────────┐      ║
║       │ │█│█│█    █│█│█│ │      ║
║       │   └█└█    █┘█┘   │      ║
║       └┐ 🔆 └█    █┘ 🔆 ┌┘      ║
║        └─────⚠️──────────┘       ║
║                                 ║
╚═════════════════════════════════╝