╔══════════ PIRATE COVE ══════════╗
║       ┌──────────────────┐      ║
║       │ │█│█│█ 🦊 █│█│█│ │      ║
║       │   └█└█    █┘█┘   │      ║
║       └┐ 🔆 └█    █┘ 🔆 ┌┘      ║
║        └─────🪧──────────┘       ║
║                                 ║
╚═════════════════════════════════╝