╔════════════ COCINA ════════════╗
╚                                ╝
╔  ┌───────────┐  ┌───────────┐  ╗
║  │╬═╬═╬═╬═╬═╬│  │╬═╬═╬═╬═╬═╬│  ║
║  └o─o─o─o─o─o┘  └o─o─o─o─o─o┘  ║
║         ┌────────────┐         ║
║    🦊   │████████████│   🐰    ║
╚════╝ ╚═════════════════╝ ╚═════╝