╔═══ 🚻  BAÑOS 🚻  ═══╗
║  ┌───┐ ┌───┐ ┌───┐  ║
║  │ o │ │ o │ │ o │  ║
║  │   │ │   │ │   │  ║
╚  └─┘ ┘ └─┘ ┘ └─┘ ┘  ║
╔                     ║
║   o╩o   o╩o   o╩o   ║
║  └───────────────┘  ║
╚═════════════════════╝